#####################################################################################################
#S                        #               #           #   #   #         #           #     #   #   # #
# ############# # # ####### # ##### # ### # ### ##### # # # # # ### ### # ####### # # # # # # # # # #
#           #   # #         #   #   # #   # #   #     # #   # #   #   #   #       #   # #   #   # # #
# ########### ### # ######### # # ### # ### # ######### ### ##### ##### ### # ######### # ##### # # #
# # #     #   #   # #       # # #   # #   # #   #     #   #       #   # #   #     #   # #     # # # #
# # # ### # ### # ### ##### # # ### # ##### ### # ### ### # # ##### # ### # ####### # # ##### # # # #
#   # #   #   # # #   #     # # #   #   #   #   #   #     # #     # #     # # #     #   #   # # #   #
##### # ##### # ### ### ##### # # ####### # # ##### ####### ##### # ### ### # # ######### # # # #####
#     #     # #   #   # #   # # #     #   # #       #     # #     #   #   #   # #   #   # # # #     #
# ########### ### # ### # ### # ##### # ### ######### ##### # ##### # ### ##### ### ### # # # # ### #
# #           #   # #   #     # #   # #   #       #   #     #   #   #   #   # #   #   # # #   #   # #
# # ### ####### ##### ######### # # # # # # ##### # ### # ### ### # ### ### # # # ### # # ######### #
# #   #       # #   #       #   # # # # # # #     # #   #   # #   #   #   #   # #     #   #   #   # #
# ### ##### # # # # ####### # ### # # ### # # ##### # ##### # # ### ##### ##### ############# # # # #
#     #   # # #   #       # #   # # #   # # # #   #   #     # #   # #   # #   #               # #   #
# ##### # ### # ### ##### # # # ### ### # ### # # ##### ##### # # ### # ### # ####### # ####### #####
#     # #   # #   #     #   # #   # #   # #   # #   #   #     # #     #     #       # #   #   #     #
##### # # # # ### ####### ### ### # # ### # ### ### # ############################# # ##### # ##### #
#     # # #   #   #     #   # # #   #     #   #   #   #     #             #     #   #   #   #     # #
# ##### ####### ### # # ### # # # ####### # # ### ##### # # # ########### ##### # ##### # ####### # #
#   # #       # #   # # # # #   #       # # # #   #     # #   #     #   #   #   #   #   # #     # # #
### # ##### # ### ##### # # # ######### # # # ##### ### # # ### # # # # ### # # ### ##### # ### # # #
#   # #   # #   # #     #   # # #     # # # #     #   # # # #   # # # #     # #   # #   #   #   # # #
# ### ### # ### ### ######### # # ##### # ### ### ### # # ### ##### # # ##### ### # # # ##### ### # #
#   #   # #   #   #   #   #   # #       #   #   #     # # #   #   # # # # #   #   #   #   #   #   # #
# # ### # ### # # ### # # # ### # ####### # ### ######### # ### # # # # # # ### ######### # ### # # #
# #     # #   # #   #   # #   # #       # #   #   #       #   # # #   # # #   #   #   #   # #   # # #
# ##### # ######### ##### # # # ####### ##### # # # # ####### # # ##### # # # ### # ### ##### ### # #
#     # #     #   #       # #   #     # #     # # # #       # # #     # # # #   # #   #     # #   # #
##### # ##### # # ### ##### ##### ### ### # ##### # ####### # # # ### # # # ### # ### # ### # ##### #
# #   #     #   #   # #   # #     # #     # #     #     #   #   # #   #   #   # #   # #   # #       #
# # ####### ####### ### # ### # ### # ##### # ######### ######### # ### ##### # ### # # # # ##### ###
# #     #   #     #     #     # #   #     # #         #         # #   #   #   #   #   # # #     #   #
# ##### # ### # # ############### ### ##### # ####### ######### ##### ##### # ### ##### # ##### #####
#   #   #     # # #     #       #   # #     #       #         #   # #   #   #   #     # # # #   #   #
### # ######### # # ### # # ### ### # # ########### ########### # # ### # ########### # # # # ### # #
#   #       #   # #   #   # #   #   # #   #       #   #       # # #   # #     #       # #   #   # # #
# ######### # ### ### ##### # ### ### # # ####### ### # ### # ### ### # ##### # # ##### # # ### # # #
#       #   #   #     #     #     #   # # #     # # # #   # #   #     # #     # #   # # # # # # # # #
# # # # # # ### ####################### # # # # # # # ### # ### ####### # ##### # # # # # # # # # # #
# # # #   #   #           #   #     #   #   # #   # # #   #   #   #     # # #   # #   # # #   #   # #
# # ##################### # # ##### # ### ####### # # # ####### # # # ### # # ##### ### # ######### #
# #   #   #   #         #   # #     #   # #     # # # #   #   # #   #   # # #     #   # #         # #
# # # ### # # ######### # # # # # ##### ### ### # # # # # # # ##### ### # # ##### ### # # ####### # #
# # #     # # #     #   # # # # #   # #     #   # # # # #   #     #   # #   #     # # # # #     # # #
# ######### # # ### # ### # # # # # # ####### ##### # # ######### ### # ##### # # # # # ### # # ### #
#           #   # #   #   # #   # # #   #   # #   # # #         # #   #   #   # # #   # #   # # #   #
################# ##### ### ##### # # # ### # ### # # ######### # # ####### # # # ### # # ##### # ###
#     #         #       #   #   # # # # #   #     # # #   #   # # #   #     # # #   # # # #   # #   #
# ##### ####### # ####### # # # # # # # # # ####### # # # # # # # ##### ####### ### # # ### # # # # #
#     #   #     #   #     # # # # # # # # #   #   #   # #   #   #     # # #   #   # # #     #   # # #
# # # ### # ### ### # # ##### # # # ### # # # # ####### # # ######### # # # # ### # ########### # ###
# # #   # #   #   # # # #   # # # #     # # #   #       # #   #   #   # #   #   # # #     #   # #   #
# ### # # ### ##### # ### # # ### # ##### # ### # # ##### # ### # # ### # ##### # # # # # ### ##### #
#   # #   #   #   # #   # #   #   #     # #   # # #   #   # #   # # #   #     #   #   # #     #     #
# # ####### ### # ##### # ##### ####### # ### # # ### # ##### ### # # # ##### # ### ### ####### #####
# #   #   # #   # #     # #     #     # # #   # #   # #       #   #   #   #   #   # #   #   # #   # #
# ### # # # # # # # # # # # # ### ### # # ######### # ##### ### # ####### # # ### ### # # # # # # # #
#   #   # # # # #   # # #   # #   # #   #       #   # #   # #   # #       # #   #   # # # # # # # # #
##### ### # # ####### # ####### # # # ######### # ##### # ### ### # ##### # ### ### # ### # # # # # #
#   #   # # #     #   # #   #   # # #   #     # #   #   #   # #   #     # #   # #   #   # # # # #   #
# # ##### # ### # # ### # # # ##### ### # ### # ### # # ### # # ####### # ### ### ### # # # # # #####
# # #     #   # # #   # # # #       #   # #   #     # # # # # # #     # #   #   #   # #   #   # #   #
# # # # ##### ### ### # # # ### ##### # ### # ####### # # # # # # ### # ### # # # # # ######### # ###
# #   #   # #   # #   # # #   #     # # #   #     #   # # #   # # #   # #   # # # # #       #   #   #
# # ##### # # # # ##### # # # ##### # ### ######### ### # ####### # ### # ### # ### ####### # # ### #
# # #   #   # # # #   # # # # #   # #   # #         #   # #   #   #   # # #   #   #     # # # # #   #
# # # # ##### # # # # ### # # ### # # # # # ######### ### # # # ##### # # ### ### ### # # # # # # ###
# #   #   #   #   # #     # #   #   # #   # #     #   #   # # #     #   #   #   #   # # #   # # #   #
# ####### # ### ### ######### # ### # ##### # ### # # # # # # ####### ##### # ##### ### ##### # ### #
# #   #   #   #   # #       # #   # #     #   #   # # # # # #       #     # # #   #   #     # #   # #
# # ### ##### ### # ####### # ### # ########### ### ### # # ####### ####### # # ### # ##### # ##### #
# #     #   #   # # #   #   # #   #   # #     # #   #   # #       # #     # # #   # # #     #     # #
# ####### ##### # # # # # ### # # # # # # # # # # ### # ####### # # # ### # ##### # # ### # ##### # #
#       # #     # #   #   #   # # # # # # # #   #   # # #     # # #   #   #       # #   # #     #   #
####### # # ##### ############# # # # # # # ####### # # # ### ### ##### ########### ### # ##### # ###
#   #   #   #   #         #     # # # # # #   #   # # # #   #   # #     #       #   #   #   # # # # #
# # # ##### # ########### # # ### ### # # ### # ### # # ### # # # # ##### # ### # ### ##### # # # # #
# # #     # #             # #   #   #   #   # # #   # # # # # #   #       #   # #   #   #   #   #   #
# ####### # ##### ######### ####### ####### # # # ### # # # ########### ##### # ####### # # #########
#         #     # #       #       # #     # #   #     #   # #         # # #   #   #   # # # #       #
# ####### ##### ### # ### # ##### # ##### # ######### ##### # ####### # # # ##### # # # # ### ##### #
# #     #   # #   # #   # # # #   #       #         # #     #     #   #   #     #   # # # #   #   # #
# # # # ### # ### # ### # # # # ########### # ##### # # ########### # ######### # ### # # # ### ### #
#   # #   # # #   #   # # #   #           # #   #   # # #           # #         #   #   #   #   #   #
##### # # # # # ##### ### # ############# # ##### # # # # # ######### # ########### ##### ### ### # #
#     # # #   #     # #   # #     #   #   # #     # # #   # #       # # #       #   #   #   #   # # #
# # ##### # ####### # # # # ##### # # # ##### ##### # ####### # ### ### # ##### # ##### ### # # # # #
# # #   # #     # # # # # #     #   # #     # #     #       # #   #   # #     #   #     #   # #   # #
# ### # # ##### # # # # # # # # ##### ### # # # # ######### # ####### # ##### ##### ##### ###########
#     # # #   # # # # # # # # #     #   # # # # #   #   #   # #       #   #   #     #     #   #     #
# ##### # # # # # # ### # # ####### ### # # # # # # # # # ### # ######### # ### # ### ##### # ##### #
# #     #   # #   #     # # #     #   # # #   # # #   # #     # #   #   # #     #   #       #     # #
# # ######### # ######### ### ### ### # ####### # ##### ####### ### # ### ######### ####### ### # # #
# # #     #   #   #     #   #   #   #   #       #     #     # # #   #   #   #     #   #   #   # #   #
# # # ##### ####### # # # # ### # # ##### ### ####### ##### # # # # ### ### # ####### # # ### # #####
# # #     # #   #   # # # #     # # #   #   # #   # #   # #   # # # # #   # #       #   # # # #     #
# # ##### # # # # ### # ########### # ##### # # # # # # # # ### # # # # # # # ##### ##### # # ##### #
# #     #   # #   #   #             #       #   #   # #   #   #   #   # #   #     #       #   #    F#
#####################################################################################################
