###########
#     #  F#
### ### ###
# # # #   #
# # # # # #
# # # # # #
#   # # ###
# #     # #
# ### # # #
#S    #   #
###########