#####################
#S#   #             #
# # # # # # ####### #
#   # # # #   #   # #
# # # ### # # # # # #
# # #     # # # # # #
# ######### # # # # #
#     #     #   # # #
# ### # ######### # #
#   # #   #   #   # #
##### ##### # # ### #
#     #     # #   # #
# ##### ##### ##### #
#     # #   # #     #
# ### # # # # # #####
# #   #   # # #   # #
# # ####### # # # # #
# #   #     # # #   #
# ### # ##### # #####
#   #   #     #    F#
#####################
