#########################################
#S  # #     #     #   #       #   # #   #
# ### # ##### # ##### # ####### ### # ###
# # #         #           #         #   #
# # # ####### # ### ### # # ### ##### ###
#     # # # # # #   # # # # # #       # #
# ### # # # ####### # # ### # ### # ### #
#   # #       #   #   #         # # # # #
# ##### ####### ####### ### # ####### # #
#       #   # #     #     # # #         #
# # ### # ### # ### ####### ### # #######
# #   # #       # #   # #       #     # #
# # ##### ### ### ##### ##### ####### # #
# #       #               #         #   #
### ### ### # # ### ### ####### # ### ###
# #   #   # # #   #   # #   # # #   # # #
# # # # ################### # # ####### #
#   # # #   # # # # # # #     #     # # #
# # ####### # # # # # # # ########### # #
# # # #     #             #   # #   #   #
### # # # ### ############# ### # ##### #
#     # #       # #   # #     #     #   #
# ### ### ####### # ### # ####### # ### #
#   #       # # #           #     #     #
##### # # ### # # ### ### # ### #########
#   # # #         #     # # #           #
### ##### ### ####### ### ### ### #######
#         #   #   # #   #     # #   #   #
######### ### # # # # ####### # # ### ###
#           #   # # #       #   #       #
##### ####### # ### # ### # # ### # ### #
#         # # #     #   # # # #   # #   #
### # # ### # # # ### ### ####### #######
#   # #   #   # #   #   # # #   #       #
### # ##### ##### ######### ### ### #####
#   #   # #   #           #       #   # #
### # ### # ##### # ##### # ####### ### #
#   #   #     #   #   # # # # # # #   # #
# # # ### # ### # ##### ### # # # ##### #
# # #   # #   # #                      F#
#########################################
